#................#  
#................#  
#................#  
#..############..#  
#.......##.......#  
####...####...####  
#................#  
#..#####..#####..#  
#................#  
####...####...#### 
#................#  
#..############..#  
#................#  
##################
